1233333321
4658008564
1777777777
3265555623
0011221100
7766556677